batt = batt
clean = clean
clear = clear
clock = clock
flip = flip
history = history
mount = mount
scan = scan
scandump = scandump
space = space
system = system
umount = umount
bg_color = bg_color
bright = bright
captive = captive
chdir = chdir
env_get = env_get
exe = exe
fg_color = fg_color
help = help
hi_color = hi_color
list = list
mkdir = mkdir
mkfile = mkfile
net = net
rmdir = rmdir
roll = roll
sound = sound
speed = speed
vol = vol
alias = alias
copy = copy
env_set = env_set
ping = ping
redir = redir